#India
BNI = "countries/Bonai.txt"
BNS = "countries/Banswara.txt"
CER = "countries/Chero.txt"
DUN = "countries/Dungarpur.txt"
KAU = "countries/Karauli.txt"
KFA = "countries/Khalifatabad.txt"
PRT = "countries/Kanthal.txt"
SIR = "countries/Sirohi.txt"

#Philippines
BAI = "countries/Ma-i.txt"
DAP = "countries/Dapitan.txt"
IBA = "countries/Ibalon.txt"
IFU = "countries/Ifugao.txt"
IVA = "countries/Ivatan.txt"
ETE = "countries/Mairete.txt"
LAW = "countries/Lawan.txt"
SAW = "countries/Libog.txt"
SIQ = "countries/Katugasan.txt"
TAY = "countries/Taytay.txt"

#Polynesia
HAW = "countries/Hawaii.txt"
HKA = "countries/Kau.txt"
HIL = "countries/Hilo.txt"
HNA = "countries/Hana.txt"
HWI = "countries/HawaiiFormable.txt"
KAI = "countries/Kauai.txt"
KOH = "countries/Koholalele.txt"
MAU = "countries/Maui.txt"
MOO = "countries/Molokai.txt"
RAP = "countries/Rapanui.txt"
OAH = "countries/Oahu.txt"
UMI = "countries/UmiRevolt.txt"
 
#Indochina + Burma
ANG = "countries/Angkor.txt"
KEN = "countries/Kengtung.txt"
LAM = "countries/Haripunchai.txt"

#Japan
HON = "countries/Honma.txt"

#Miscellaneous
RUF = "countries/Tamna.txt"